WE FAKE
SO ./images/wall.xpm
WE ./images/wall.xpm
EA ./images/wall.xpm

F 220,210,185
C 196,156,63

11111111111111
10000000000001
10000000000001
10000001000001
10000000000001
100000000000N1
11111111111111
