SO	./images/south_wall.xpm
EA	./images/south_wall.xpm

F	255, 255, 255

C	120, 0, 0

WE	./images/south_wall.xpm
NO ./images/south_wall.xpm

111111111111111111111111
100000000000000000000001
100000000000000000000001
100000000000000000000001
100000000S00000000000001
100000000000000000000001
100000000000000000000001
100000011211112110000001
100000010000000010010001
100000010000000020000101
100110010000000010000001
100000010000000010000001
100000010000000020000001
100000020000000010000001
100000010000000010000001
100000010000000020000001
100000010000000010000001
100000010000000010000001
100000010000000010000001
100000010000000010000001
100000010000000010000001
100000010000000010000001
100000010000000010000001
100000010000000010000001
100000010000000010000001
100000010000000010000001
100000010000000010000001
100000010000000010000001
100000010000000010000001
100000010000000010000001
100000010000000110000001
100000011211121110000001
100000000000000000000001
100000000000000000000001
100000000000000000000001
100000000000000000000001
100000000000000000000001
100000000000000000000001
111111111111111111111111
