SO	./images/wall.xpm
EA	./images/wall.xpm

F	135, 126, 126

C	121, 220, 220

WE	./images/wall.xpm
NO ./images/wall.xpm

111111111111111111111111
100000000000000000000001
100000000000001000000001
100000000010000000000001
100000000000000000000001
100000000001000000000001
100000000000000000000001
100000011111111110000001
100000011111111110010001
100000011111111110000101
100110011111111110000001
100000011111111110000001
100000011111111110000001
100000011111111110000001
100000011111111110000001
100000011111111110000001
100000011111111110000001
100000011111111110000001
100000011111111110000001
100000011111111110000001
100000011111111110000001
100000011111111110000001
100000011111111110000001
100000011111111110000001
100000011111111110000001
100000011111111110000001
100000011111111110000001
100000011111111110000001
100000011111111110000001
100000011111111110000001
100000011111111110000001
100000011111111110000001
100000011111111110000001
100000011111111110000001
100W00011111111110000001
100000000000000000000001
100000000000000000000001
100000000000000000000001
100000000000000000000001
100000000000000000000001
100000000000000000000001
111111111111111111111111
