SO	./images/south_wall.xpm
EA	./images/south_wall.xpm

F	135, 126, 126

C	121, 220, 220

WE	./images/south_wall.xpm
NO ./images/south_wall.xpm

111111111111111111111111
100000000000000000000001
100000000000000000000001
100000000000000000000001
100000000000000000000001
100000000000000000000001
100N00000000000000000001
100000011211112110000001
100000011111111110010001
100000011111111120000101
100110011111111110000001
100000011111111110000001
100000011111000020000001
100000020000011110000001
100000011111111110000001
100000020000000020000001
100000011011101110000001
100000020011101110000001
100000010011101110000001
100000020011101110000001
100000010111101110000001
100000020011101110000001
100000010111101110000001
100000020111101110000001
100000010111101110000001
100000020111101110000001
100000010111101110000001
100000020111101110000001
100000020111101110000001
100000010111111110000001
100000010000000110000001
100000011211121110000001
100000000000000000000001
100000000000000000000001
100000000000000000000001
100000000000000000000001
100000000000000000000001
100000000000000000000001
111111111111111111111111
