SO	./images/mossy.xpm
EA	./images/purplestone.xpm

F	135, 126, 126

C	121, 220, 220

WE	./images/redbrick.xpm
NO ./images/wood.xpm

111111111111111111111111
100000000000000000000001
100000000000001000000001
100000000010000000000001
100000000000000000000001
100000000001000000000001
100000000000000000000001
100000011211112110000001
100000011111111110010001
100000011111111120000101
100010011111111110000001
100000011111111110000001
100000011111111120000001
100000021111111110000001
100000011111111110000001
100000021111111120000001
100000011111111110000001
100000021111111110000001
100000011111111110000001
100000021111111110000001
100000011111111110000001
100000021111111110000001
100000011111111110000001
100000021111111110000001
100000011111111110000001
100000021111111110000001
100000011111111110000001
100000021111111110000001
100000011111111110000001
100000021111111110000001
100000011111111110000001
100N00011211121110000001
100000000000000000000001
100000000000000000000001
100000000000000000000001
100000000000000000000001
100000000000000000000001
100000000000000000000001
111111111111111111111111
