111111111111111111111111
100010001000000000000001
100000111110000000000001
100000000100000110000001
100000000000000110000001
100000000P00000000000001
100111110000000000000001
100000000000000000000001
111111111111111111111111
