SO ./images/doors_closed.xpm
EA		  		./images/doors_open.xpm
F 	200, 			100		, 			2

C 	 255, 255	,									255

WE					./images/south_wall.xpm
NO 											./images/doors_open.xpm


111111111111111111111111
100010001000000000000001
1000011111000000W0000001111111
100000000100000110000000000001
100000000000000110000001111111
100000000000000000000001
100111110000000000000001
100000000000000000000001
111111111111111111111111
