111111111111111111111111
100001000000000000000001
100001000000000000000001
100001000000000110000001
100001000000000110000001
100000000100000000000001
100000000100000000000P01
100000000100000000000001
111111111111111111111111
