SO ./images/wall.xpm
EA		  		./images/wall.xpm
F 	200, 			100		, 			2

C 	 255, 255	,									255

WE					./images/wall.xpm 
NO 											./images/wall.xpm





111111111111111111111111
100010001000000000000001
100001111100000000000001111111
100000000100000110000000000001
100000000000000110000001111111
100000000N00000000000001
100111110000000000000001
100000000000000000000001
111111111111111111111111
