111111111111111111111111
100001001000000000000001
100001001110000000000001
100001000P00000110000001
100001000000000110000001
100000000100000000000001
100000000100000000000001
100000000100000000000001
111111111111111111111111
