111111111111111111111111
100030001000000000000001
100000111110000000000001
100000000P00000110000001
100000000000000110000001
100000000000000000000001
100100000000000000000001
100000000000000000000001
111111111111111111111111
