SO ./images/wall.xpm
EA		  		./images/wall.xpm
F 	200, 			100		, 			2

C 	 255, 255	,									255

WE	./images/wall.xpm
NO ./images/wall.xpm

111111111111111111111111
100010001000000000000001
100000111110000000000001
100000000100000110000001
100000000000000110000001
1000000000000N0000000001
100111110000000000000001
100000000000000000000001
 11111111111111111111111
