SO ./images/wall.xp
EA		  		./images/wall.xpm
F 	100, 			100		, 			2

C 	 200, 255	,									200

WE	./images/wall.xpm
NO ./images/wall.xpm


111111111111
1001 101001
1001 101N01
1111111111
111
111111