111111111111111111111111
100001000000000000000001
100001000000000000000001
100001000000000110000001
100001000000000110000001
100000000000000000000001
10000000000000000P000001
100000000000000000000001
111111111111111111111111