SO	./images/south_wall.xpm
EA	./images/south_wall.xpm

F	135, 126, 126

C	121, 220, 220

WE	./images/south_wall.xpm
NO ./images/south_wall.xpm

1111111111111111
1000000000000001
100N000000000001
1000001111000001
1000001111001001
1000001111000001
1001101111000001
1000001111000001
1111111111111111
