SO	./images/wall_starwars.xpm
EA	./images/wall_starwars.xpm

F	135, 126, 126

C	121, 220, 220

WE	./images/wall_starwars.xpm
NO ./images/wall_starwars.xpm


11111111111111111111111111111111111111111111111111111111111111111
11111111111111111111111111111110000000000000000111111111111111111
11111111111111111111111111111110000000000000000111111111111111111
10000000000000000000000011111110000000000000000111111111111111111
10000000000000000000000011111110000000000000000111111111111111111
10000000000000000000000011111110000000000000000111111111111111111
10000000000000000000000011111110000000000000000111111111111111111
10000000000000000000000011111110000000000000000111100000000000001
10000000000000000000000010000010000000000000000111100000000000001
10000000000000000000000020000020000000000000000000200000000000001
10000000000000000000000010000010000000000000000111100000000000001
10000000000000000000000011111110000000000000000111100000000000001
10000000000000000000000011111110000000000000000111100000000000001
10000000000000000000000011111110000000000000000111111100000000001
10000000000000000000000011111110000000000000000111100000000000001
10000000000000000000000011111110000000000000000111100000000000001
11111111111112111111111111111110000000000000000111100000000000001
11111111100000000001111111111110000000000000000111100000000001111
11111111100000000001111111111110000000000000000111100000000000001
11111111100000000001111111111111111111111111111111100000000000001
11111111100000000001111111111111111111111111111111100000000000001
11111111100000000001111111111111111000000000011111111110000000001
11111111111111111111111111111111111000000000010000000000000000001
11111111111111111111111111111111111000000000020000000000000000001
11111111111111111111111111111111111000000000010000000000000000001
11111111111111111111111111111111111000000000011111111111111111111
11111111111111111111111111111111111111121111111111111111111111111
11111111111111111111111111110000000000000001111111111111111111111
11111111111111111111111111110000000000000001111111111111111111111
11111111111111111111111111110000000000000001111111111111111111111
11111111111111111111111111110000000000000001111111111111111111111
11111111111111111111111100000000000000000001111111111111111111111
11111111111111111111111100000000000000000001111111111111111111111
11111111111111111111111100000000000000000001111111111111111111111
1111111111111111111111110000N000000000000001111111111111111111111
11111111111111111111111100000000000000000001111111111111111111111
11111111111111111111111111111111111111111111111111111111111111111
