SO	./images/south_wall.xpm
EA	./images/south_wall.xpm

F	135, 126, 126

C	121, 220, 220

WE	./images/south_wall.xpm
NO ./images/south_wall.xpm

111111111111111111111111
1111111000000001
1111111110000001
1000000111111111
1000000200000001
1111111100000001
1111111000000001
1111111111111211
1111111000000001
1111111000000001
1111111000000001
1111111000000001
1111111000000001
1111111000000001
1111111000000001
1111111000000001
1111111000000001
1111111121111111
1111111000000001
1111111000000001
1111111000000001
1111111000000001
1111111000000001
1111111000000001
1111111000000001
11111111111111211
1000000000020001
1000000011111111
10000001
10000001
10000001
1121111
1000011
10N0011
1000011
1000011
1000011
1000011
1111111
